211111111
533111111
115333111
111115331
111111151
111111150
