100000000
100000000
110000000
011111000
000011000
000011112
