231111111
141111111
341111111
111111111
111111111
111111110
