99999999999
92111111119
91111111119
91111111119
91111111119
91111111119
91111111109
99999999999
