110000000
011100000
000110000
000010000
000011110
000000012
